          #######
          #  OOO#
      #####  OOO#
      #      OOO#
      #  ##  OOO#
      ## ##  OOO#
     ### ########
     # XXX ##    
 #####  X X #####
##   #X X   #   #
#P X  X    X  X #
###### XX X #####
     # X    #    
     #### ###    
        #  #     
        #  #     
        #  #     
	#### 
